PPPPPPPPPPPPPPPPPPPPPPPPPPPPPPPPPPPPPPPPPPPPPPPPPPPPPPPPPPPPPPPPPPPPPPPPPPPPPPPP
PPPPPPPPPPPPPPPPPPPPPPPPPPPPPPPPPPPPPPPPPPPPPPPPPPPPPPPPPPPPPPPPPPPPPPPPPPPPPPPP
PPPPPPPPPPPPPPPPPPPPPPPPPPPPPPPPPPPPPPPPPPPPPPPPPPPPPPPPPPPPPPPPPPPPPPPPPPPPPPPP
PPPPPPPPPPPPPPPPPPPPPPPPPPPPPPPPPPPPPPPPPPPPPPPPPPPPPPPPPPPPPPPPPPPPPPPPPPPPPPPP
PPPPPPPPPPPPPPPPPPPPPPPPPPPPPPPPPPPPPPPPPPPPPPPPPPPPPPPPPPPPPPPPPPPPPPPPPPPPPPPP
PPPPPPPPPPPPPPPPPPPPPPPPPPPPPPPPPPPPPPPPPPPPPPPPPPPPPPPPPPPPPPPPPPPPPPPPPPPPPPPP
PPPPPPPPPPPPPPPPPPPPPPPPPPPPPPPPPPPPPPPPPPPPPPPPPPPPPPPPPPPPPPPPPPPPPPPPPPPPPPPP
PPPPPPPPPPPPPPPP............................VVVV......................PPPPPPPPPP
PPPPPPPPPPPPPPPP............................VVVV......................PPPPPPPPPP
PPPPPPPPPPPPPPPP............................VVVV......................PPPPPPPPPP
PPPPPPPPPPPPPPPP............................VVVV......................PPPPPPPPPP
PPPPPPPPPPPPPPPPPPPPPPPPPPPPPPPPPPPPPCCCCCCCCCCTC.....................PPPPPPPPPP
PPPPPPPPPPPPPPPPPPPPPPPPPPPPPPPPPPPPP..........E......................PPPPPPPPPP
PPPPPPPPPPPPPPPPPPPPPPPPPPPPPPPPPPPPP..........E......................PPPPPPPPPP
PPPPPPPPPPPPPPPPPPPPPPPPPPPPPPPPPPPPP..........E......................PPPPPPPPPP
PPPPPPPPPPPPPPPPPPPPPPPPPPPPPPPPPPPPP..........E......................PPPPPPPPPP
PPPPPPPPPPPPPPPPPPPPPPPPPPPPPPPPPPPPPCCCCCCCCCCECCCCCCCCCGGGGGGGGGGGGGPPPPPPPPPP
PPPPPPPPPPPPPPPPPPPPPPPPPPPPPPPPPPPPPCCCCCCCCCCCCCCCCCCTCGGGGGGGGGGGGGPPPPPPPPPP
PPPPPPPPPPPPPPPGGGGGGGGMMMMGGGGGGGGGGGGMMMMGGGGGGGGGGGGEGGGGGGGGGGGGGGPPPPPPPPPP
PPPPPPPPPPPPPPPGGGGGGGGMMMMGGGGGGGGGGGGMMMMGGGGGGGGGGGGEGGGGGGGGGGGGGGPPPPPPPPPP
PPPPPPPPPPPPPPPGGGGGGGGMMMMGGGGGGGGGGGGMMMMGGGGGGGGGGGGEGGGGGGGGGGCCCCPPPPPPPPPP
PPPPPPPPPPPPPPPGGGGGGGGMMMMGGGGGGGGGGGGMMMMGGGGGGGGGGGGEGGGGGGGGGGCTCCPPPPPPPPPP
PPPPPPPPPPPPPPPGGGGGGGGMMMMGGGGGGGGGGGGMMMMGGGGGGGGGGGGEGGGGCCCCCG.E..PPPPPPPPPP
PPPPPPPPPPPPPPPGGGGGGGGLLLLGGGGGGGGGGGGLLLLGGGGGGGGGGGGEGGGGCCCCCG.E..PPPPPPPPPP
PPPPPPPPPPPPPPPGGGGGGGGLLLLGGGGGGGGGGGGLLLLGGGGGGGGGGGCCCCCGGGGGGG.E..PPPPPPPPPP
PPPPPPPPPPPPPPPGGGGGGGGLLLLGGGGGGGGGGGGLLLLGGGGGGGGGGGCCCCCGGGGGGG.E..PPPPPPPPPP
PPPPPPPPPPPPPPPGGGGGGGGLLLLGGGGGGGGGGGGLLLLGGGCCCCCCCGGGGGGGGGGGGG.E..PPPPPPPPPP
PPPPPPPPPPPPPPPGGGGGGGGLLLLGGGGGGGGGGGGLLLLGGGGGGTGGGGGGGGGGGGGGGG.E..PPPPPPPPPP
PPPPPPPPPPPPPPPCCCCCCGLLLLLGCCCCCCCCCGGLLLLGGGGGGEGGGGGGGGGGGGGGGG.E..PPPPPPPPPP
PPPPPPPPPPPPPPPCCCCTCGLLLLLGCCCTCCCTCGGLLLLGGGGGGEGGGGGGGGGGGGGGGG.E..PPPPPPPPPP
PPPPPPPPPPPPPPPGGGGE.GLLLLLGGGGEGGGEGGGLLLLGGGGGGEGGGGGGGGGGCCCCCCCCCCPPPPPPPPPP
PPPPPPPPPPPPPPPGGGGE.GLLLLLGGGGEGGGEGGGLLLLGGGGGGEGGGGGGGGGGGTCCCCCCCCPPPPPPPPPP
PPPPPPPPPPPPPPPGGGGE.GLLLLLGGGGEGGGEGGGLLLLGGGGGGEGGGGGGGGGGGEGGGGGGGGPPPPPPPPPP
PPPPPPPPPPPPPPPGGGGE.GLLLLLGGGGEGGGEGGGLLLLGGGGGGEGGGGGGGGGGGEGGGGGGGGPPPPPPPPPP
PPPPPPPPPPPPPPPGGGGE.GLLLLLGGGGEGGGEGGGLLLLGGGGCCCCCCGGGGGGGGEGGGGGGGGPPPPPPPPPP
PPPPPPPPPPPPPPPGGGGE.GLLLLLGGGGEGGGEGGGLLLLGGGGCCCCCCGGGGGGGGEGGGGGGGGPPPPPPPPPP
PPPPPPPPPPPPPPPGGGGE.GLLLLLGGGGEGGGEGGGLLLLGGGGGGGGGGGCCCCCGGEGGGGGGGGPPPPPPPPPP
PPPPPPPPPPPPPPPGGGGE.GLLLLLGGGGEGGGEGGGLLLLGGGGGGGGGGGCCCCCGGEGGGGGGGGPPPPPPPPPP
PPPPPPPPPPPPPPPGGGGE.GLLLLLGGGGEGGGEGGGLLLLGGGGGGGGGGGGGGGGGCCCCCGGGGGPPPPPPPPPP
PPPPPPPPPPPPPPP....E.GLLLLLGGGGEGGGEGGGLLLLGGGGGGGGGGGGGGGGGCCCCCGGGGGPPPPPPPPPP
PPPPPPPPPPPPPPPCCCCCCGLLLLLGGGGEGGGEGGGLLLLGGGGGGGGGGGGGGGGGGGGG.GCCCCPPPPPPPPPP
PPPPPPPPPPPPPPPCCTCCCGLLLLLGGGGEGGGEGGGLLLLGGGGGGGGGGGGGGGGGGGGG.GCTCCPPPPPPPPPP
PPPPPPPPPPPPPPP..E...GLLLLLGGGGEGGGEGGGLLLLGGGGGGGGGGGGGGGGGGGGG.G.E..PPPPPPPPPP
PPPPPPPPPPPPPPP..E...GLLLLLGGGGEGGGEGGGLLLLGGGGGGGGGGGGGGGGGGGGG.G.E..PPPPPPPPPP
PPPPPPPPPPPPPPP..E...GLLLLLGGG.E...E.GGLLLLGGGGGGGGGGGGGGGGGGGGG...E..PPPPPPPPPP
PPPPPPPPPPPPPPP..E...GLLLLLGGGCCCCCCGGGLLLLGGGGGGGGGGGGGGGGGGGGGCCCCCCPPPPPPPPPP
PPPPPPPPPPPPPPP..E...GLLLLLGGGGGGGGGGGGLLLLGGGGGGGGGGGGGGGCCCCCG......PPPPPPPPPP
PPPPPPPPPPPPPPP..E...GLLLLLGGGGGGGGGGGGLLLLGGGGGGGGGGGGGGGCCCCCG......PPPPPPPPPP
PPPPPPPPPPPPPPP..E...GLLLLLGGGGGGGGGGGGLLLLGGGGGGGGGCCCCCG.....G......PPPPPPPPPP
PPPPPPPPPPPPPPP..E...GLLLLLGGGGGGGGGGGGLLLLGGGGGGGGGCCCCCG.....G......PPPPPPPPPP
PPPPPPPPPPPPPPPCCCCCCGLLLLLGGGGGGGGGGGGLLLLGCCCCCCCG.....G.....G......PPPPPPPPPP
PPPPPPPPPPPPPPPCCCCCCGLLLLLGGGGGGGGGGGGLLLLGCCCCCCCG.....G.....G......PPPPPPPPPP
PPPPPPPPPPPPPPP......GGGGGGGGGGGGGGGGGGGGGGG.......G.....G.....G......PPPPPPPPPP
PPPPPPPPPPPPPPP..CCCCCCCCCCCCCGGGGGGGGCCCCCG.......G.....G.....G......PPPPPPPPPP
PPPPPPPPPPPPPPP...............CCCCCCCC.....C.......C.....C.....C......PPPPPPPPPP
PPPPPPPPPPPPPPP.......................................................PPPPPPPPPP
PPPPPPPPPPPPPPP.......................................................PPPPPPPPPP
PPPPPPPPPPPPPPPPPPPPPPPPPPPPPPPPPPPPPPPPPPPPPPPPPPPPPPPPPPPPPPPPPPPPPPPPPPPPPPPP
PPPPPPPPPPPPPPPPPPPPPPPPPPPPPPPPPPPPPPPPPPPPPPPPPPPPPPPPPPPPPPPPPPPPPPPPPPPPPPPP
PPPPPPPPPPPPPPPPPPPPPPPPPPPPPPPPPPPPPPPPPPPPPPPPPPPPPPPPPPPPPPPPPPPPPPPPPPPPPPPP
