PPPPPPPPPPPPPPPPPPPPPPPPPPPPPPPPPPPPPPPPPPPPPPPPPPPPPPPPPPPPPPPPPPPPPPPPPPPPPPPP
PPPPPPPPPPPPPPPPPPPPPPPPPPPPPPPPPPPPPPPPPPPPPPPPPPPPPPPPPPPPPPPPPPPPPPPPPPPPPPPP
PPPPPPPPPPPPPPPPPPPPPPPPPPPPPPPPPPPPPPPPPPPPPPPPPPPPPPPPPPPPPPPPPPPPPPPPPPPPPPPP
PPPPPPPPPPPPPPPPPPPPPPPPPPPPPPPPPPPPPPPPPPPPPPPPPPPPPPPPPPPPPPPPPPPPPPPPPPPPPPPP
PPPPPPPPPPPPPPPPPPPPPPPPPPPPPPPPPPPPPPPPPPPPPPPPPPPPPPPPPPPPPPPPPPPPPPPPPPPPPPPP
PPPPPPPPPPPPPPPPPPPPPPPPPPPPPPPPPPPPPPPPPPPPPPPPPPPPPPPPPPPPPPPPPPPPPPPPPPPPPPPP
PPPPPPPPPPPPPPPPPPPPPPPPPPPPPPPPPPPPPPPPPPPPPPPPPPPPPPPPPPPPPPPPPPPPPPPPPPPPPPPP
PPPPPPPPPPPPPPPP............................VVVV......................PPPPPPPPPP
PPPPPPPPPPPPPPPP............................VVVV......................PPPPPPPPPP
PPPPPPPPPPPPPPPP............................VVVV......................PPPPPPPPPP
PPPPPPPPPPPPPPPP............................VVVV......................PPPPPPPPPP
PPPPPPPPPPPPPPPPPPPPPPPPPPPPPPPPPPPPPCCCCCCCCCCTC.....................PPPPPPPPPP
PPPPPPPPPPPPPPPPPPPPPPPPPPPPPPPPPPPPP..........E......................PPPPPPPPPP
PPPPPPPPPPPPPPPPPPPPPPPPPPPPPPPPPPPPP..........E......................PPPPPPPPPP
PPPPPPPPPPPPPPPPPPPPPPPPPPPPPPPPPPPPP..........E......................PPPPPPPPPP
PPPPPPPPPPPPPPPPPPPPPPPPPPPPPPPPPPPPP..........E......................PPPPPPPPPP
PPPPPPPPPPPPPPPPPPPPPPPPPPPPPPPPPPPPPCCCCCCCCCCECCCCCCCCCGGGGGGGGGGGGGPPPPPPPPPP
PPPPPPPPPPPPPPPPPPPPPPPPPPPPPPPPPPPPPCCCCCCCCCCCCCCCCCCTCGGGGGGGGGGGGGPPPPPPPPPP
PPPPPPPPPPPPPPP........................................E.GGGGGGGGGGGGGPPPPPPPPPP
PPPPPPPPPPPPPPP........................................E.G.GGGGGGG....PPPPPPPPPP
PPPPPPPPPPPPPPP........................................E...GGGGGGGCCCCPPPPPPPPPP
PPPPPPPPPPPPPPP........................................E...G.....GCTCCPPPPPPPPPP
PPPPPPPPPPPPPPP........................................E...GCCCCCG.E..PPPPPPPPPP
PPPPPPPPPPPPPPP........................................E...GCCCCCG.E..PPPPPPPPPP
PPPPPPPPPPPPPPP......................................GCCCCCG.....G.E..PPPPPPPPPP
PPPPPPPPPPPPPPP......................................GCCCCCG.....G.E..PPPPPPPPPP
PPPPPPPPPPPPPPP.............................GGCCCCCCCG.....G.....G.E..PPPPPPPPPP
PPPPPPPPPPPPPPP.............................GG...T...G.....G.....G.E..PPPPPPPPPP
PPPPPPPPPPPPPPPCCCCCCGGGGGGGGCCCCCCCCGGGGGGGGG...E...G.....G.....G.E..PPPPPPPPPP
PPPPPPPPPPPPPPPCCCCTCGGGGGGGGGCTCCCTCGGGGGGGGG...E...G.....G.....G.E..PPPPPPPPPP
PPPPPPPPPPPPPPPGGGGE.GGGGGGGGGGEGGGEGGGGGGGGGG...E...G.....GCCCCCCCCCCPPPPPPPPPP
PPPPPPPPPPPPPPPGGGGE.GGGGGGGGGGEGGGEGGGGGGGGGG...E...G.....GGTCCCCCCCCPPPPPPPPPP
PPPPPPPPPPPPPPPGGGGE.GGGGGGGGGGEGGGEGGGGGGGGGG...E...G.....GGEGGGGGGGGPPPPPPPPPP
PPPPPPPPPPPPPPPGGGGE.GGGGGGGGGGEGGGEGGGGGGGGGG...E...G.....GGEGGGGGGGGPPPPPPPPPP
PPPPPPPPPPPPPPPGGGGE.GGGGGGGGGGEGGGEGGGGGGGGGGGCCCCCCG.....GGEGGGGGGGGPPPPPPPPPP
PPPPPPPPPPPPPPPGGGGE.GGGGGGGGGGEGGGEGGGGGGGGGGGCCCCCCG.....GGEGGGGGGGGPPPPPPPPPP
PPPPPPPPPPPPPPPGGGGE.GGGGGGGGGGEGGGEGGGGGGGGGGGGGGGGGGCCCCCGGEGGGGGGGGPPPPPPPPPP
PPPPPPPPPPPPPPPGGGGE.GGGGGGGGGGEGGGEGGGGGGGGGGGGGGGGGGCCCCCGGE....GGGGPPPPPPPPPP
PPPPPPPPPPPPPPPGGGGE.GGGGGGGGGGEGGGEGGGGGGGGGGGGGGGGGGGGGGGGCCCCCGGGGGPPPPPPPPPP
PPPPPPPPPPPPPPP....E.GGGGGGGGGGEGGGEGGGGGGGGGGGGGGGGGGGGGGGGCCCCCG....PPPPPPPPPP
PPPPPPPPPPPPPPPCCCCCCGGGGGGGGGGEGGGEGGGGGGGGGGGGGGGGGGGGGGGGGGGG.GCCCCPPPPPPPPPP
PPPPPPPPPPPPPPPCCTCCCGGGGGGGGGGEGGGEGGGGGGGGGGGGGGGGGGGGGGGGGGGG.GCTCCPPPPPPPPPP
PPPPPPPPPPPPPPP..E...GGGGGGGGGGEGGGEGGGGGGGGGGGGGGGGGGGGGGGGGGGG.G.E..PPPPPPPPPP
PPPPPPPPPPPPPPP..E...GGGGGGGGGGEGGGEGGGGGGGGGGGGGGGGGGGGGGGGGGGG.G.E..PPPPPPPPPP
PPPPPPPPPPPPPPP..E...GGGGGGGGG.E...E.GGGGGGGGGGGGGGGGGGGGGGGGGGG...E..PPPPPPPPPP
PPPPPPPPPPPPPPP..E...GGGGGGGGGCCCCCCGGGGGGGGGGGGGGGGGGGGGGCC...GCCCCCCPPPPPPPPPP
PPPPPPPPPPPPPPP..E...GGGGGGGGGGGGGGGGGGGGGGGGGGGGGGGGGGGGGCCCCCG......PPPPPPPPPP
PPPPPPPPPPPPPPP..E...GGGGGGGGGGGGGGGGGGGGGGGGGGGGGGGGG...GCCCCCG......PPPPPPPPPP
PPPPPPPPPPPPPPP..E...GGGGGGGGGGGGGGGGGGGGGGGGGGGGGGGCCCCCG.....G......PPPPPPPPPP
PPPPPPPPPPPPPPP..E...GGGGGGGGGGGGGGGGGGGGGGGGGG....GCCCCCG.....G......PPPPPPPPPP
PPPPPPPPPPPPPPPCCCCCCGGGGGGGGGGGGGGGGGGGGGGGCCCCCCCG.....G.....G......PPPPPPPPPP
PPPPPPPPPPPPPPPCCCCCCGGGGGGGGGGGGGGGGGGGGGGGCCCCCCCG.....G.....G......PPPPPPPPPP
PPPPPPPPPPPPPPP......GGGGGGGGGGGGGGGGG.....G.......G.....G.....G......PPPPPPPPPP
PPPPPPPPPPPPPPP..CCCCCCCCCCCCCGGGGGGGG.....G.......G.....G.....G......PPPPPPPPPP
PPPPPPPPPPPPPPP...............CCCCCCCC.....C.......C.....C.....C......PPPPPPPPPP
PPPPPPPPPPPPPPP.......................................................PPPPPPPPPP
PPPPPPPPPPPPPPP.......................................................PPPPPPPPPP
PPPPPPPPPPPPPPPPPPPPPPPPPPPPPPPPPPPPPPPPPPPPPPPPPPPPPPPPPPPPPPPPPPPPPPPPPPPPPPPP
PPPPPPPPPPPPPPPPPPPPPPPPPPPPPPPPPPPPPPPPPPPPPPPPPPPPPPPPPPPPPPPPPPPPPPPPPPPPPPPP
PPPPPPPPPPPPPPPPPPPPPPPPPPPPPPPPPPPPPPPPPPPPPPPPPPPPPPPPPPPPPPPPPPPPPPPPPPPPPPPP
