PPPPPPPPPPPPPPPPPPPPPPPPPPPPPPPPPPPPPPPPPPPPPPPPPPPPPPPPPPPPPPPPPPPPPPPPPPPPPPPP
PPPPPPPPPPPPPPPPPPPPPPPPPPPPPPPPPPPPPPPPPPPPPPPPPPPPPPPPPPPPPPPPPPPPPPPPPPPPPPPP
PPPPPPPPPPPPPPPPPPPPPPPPPPPPPPPPPPPPPPPPPPPPPPPPPPPPPPPPPPPPPPPPPPPPPPPPPPPPPPPP
PPPPPPPPPPPPPPPPPPPPPPPPPPPPPPPPPPPPPPPPPPPPPPPPPPPPPPPPPPPPPPPPPPPPPPPPPPPPPPPP
PPPPPPPPPPPPPPPPPPPPPPPPPPPPPPPPPPPPPPPPPPPPPPPPPPPPPPPPPPPPPPPPPPPPPPPPPPPPPPPP
PPPPPPPPPPPPPPPPPPPPPPPPPPPPPPPPPPPPPPPPPPPPPPPPPPPPPPPPPPPPPPPPPPPPPPPPPPPPPPPP
PPPPPPPPPPPPPPPPPPPPPPPPPPPPPPPPPPPPPPPPPPPPPPPPPPPPPPPPPPPPPPPPPPPPPPPPPPPPPPPP
PPPPPPPPPPPPPPPP............................VVVV......................PPPPPPPPPP
PPPPPPPPPPPPPPPP............................VVVV......................PPPPPPPPPP
PPPPPPPPPPPPPPPP............................VVVV......................PPPPPPPPPP
PPPPPPPPPPPPPPPP............................VVVV......................PPPPPPPPPP
PPPPPPPPPPPPPPPPPPPPPPPPPPPPPPPPPPPPPCCCCCCCCCCTC.....................PPPPPPPPPP
PPPPPPPPPPPPPPPPPPPPPPPPPPPPPPPPPPPPP..........E......................PPPPPPPPPP
PPPPPPPPPPPPPPPPPPPPPPPPPPPPPPPPPPPPP..........E......................PPPPPPPPPP
PPPPPPPPPPPPPPPPPPPPPPPPPPPPPPPPPPPPP..........E......................PPPPPPPPPP
PPPPPPPPPPPPPPPPPPPPPPPPPPPPPPPPPPPPP..........E......................PPPPPPPPPP
PPPPPPPPPPPPPPPPPPPPPPPPPPPPPPPPPPPPPCCCCCCCCCCECCCCCCCCCGGGGGGGGGGGGGPPPPPPPPPP
PPPPPPPPPPPPPPPPPPPPPPPPPPPPPPPPPPPPPCCCCCCCCCCCCCCCCCCTCGGGGGGGGGGGGGPPPPPPPPPP
PPPPPPPPPPPPPPP........LLLL............LLLL............E.GGGGGGGGGGGGGPPPPPPPPPP
PPPPPPPPPPPPPPP........LLLL............LLLL............E.G.GGGGGGG....PPPPPPPPPP
PPPPPPPPPPPPPPP........LLLL............LLLL............E...GGGGGGGCCCCPPPPPPPPPP
PPPPPPPPPPPPPPP........LLLL............LLLL............E...G.....GCTCCPPPPPPPPPP
PPPPPPPPPPPPPPP........LLLL............LLLL............E...GCCCCCG.E..PPPPPPPPPP
PPPPPPPPPPPPPPP........LLLL............LLLL............E...GCCCCCG.E..PPPPPPPPPP
PPPPPPPPPPPPPPP........LLLL............LLLL..........GCCCCCG.....G.E..PPPPPPPPPP
PPPPPPPPPPPPPPP........LLLL............LLLL..........GCCCCCG.....G.E..PPPPPPPPPP
PPPPPPPPPPPPPPP........LLLL............LLLL.GGCCCCCCCG.....G.....G.E..PPPPPPPPPP
PPPPPPPPPPPPPPP........LLLL............LLLL.GG...T...G.....G.....G.E..PPPPPPPPPP
PPPPPPPPPPPPPPPCCCCCCGLLLLLGGCCCCCCCCGGLLLLGGG...E...G.....G.....G.E..PPPPPPPPPP
PPPPPPPPPPPPPPPCCCCTCGLLLLLGGGCTCCCTCGGLLLLGGG...E...G.....G.....G.E..PPPPPPPPPP
PPPPPPPPPPPPPPPGGGGE.GLLLLLGGGGEGGGEGGGLLLLGGG...E...G.....GCCCCCCCCCCPPPPPPPPPP
PPPPPPPPPPPPPPPGGGGE.GLLLLLGGGGEGGGEGGGLLLLGGG...E...G.....GGTCCCCCCCCPPPPPPPPPP
PPPPPPPPPPPPPPPGGGGE.GLLLLLGGGGEGGGEGGGLLLLGGG...E...G.....GGEGGGGGGGGPPPPPPPPPP
PPPPPPPPPPPPPPPGGGGE.GLLLLLGGGGEGGGEGGGLLLLGGG...E...G.....GGEGGGGGGGGPPPPPPPPPP
PPPPPPPPPPPPPPPGGGGE.GLLLLLGGGGEGGGEGGGLLLLGGGGCCCCCCG.....GGEGGGGGGGGPPPPPPPPPP
PPPPPPPPPPPPPPPGGGGE.GLLLLLGGGGEGGGEGGGLLLLGGGGCCCCCCG.....GGEGGGGGGGGPPPPPPPPPP
PPPPPPPPPPPPPPPGGGGE.GLLLLLGGGGEGGGEGGGLLLLGGGGGGGGGGGCCCCCGGEGGGGGGGGPPPPPPPPPP
PPPPPPPPPPPPPPPGGGGE.GLLLLLGGGGEGGGEGGGLLLLGGGGGGGGGGGCCCCCGGE....GGGGPPPPPPPPPP
PPPPPPPPPPPPPPPGGGGE.GLLLLLGGGGEGGGEGGGLLLLGGGGGGGGGGGGGGGGGCCCCCGGGGGPPPPPPPPPP
PPPPPPPPPPPPPPP....E.GLLLLLGGGGEGGGEGGGLLLLGGGGGGGGGGGGGGGGGCCCCCG....PPPPPPPPPP
PPPPPPPPPPPPPPPCCCCCCGLLLLLGGGGEGGGEGGGLLLLGGGGGGGGGGGGGGGGGGGGG.GCCCCPPPPPPPPPP
PPPPPPPPPPPPPPPCCTCCCGLLLLLGGGGEGGGEGGGLLLLGGGGGGGGGGGGGGGGGGGGG.GCTCCPPPPPPPPPP
PPPPPPPPPPPPPPP..E...GLLLLLGGGGEGGGEGGGLLLLGGGGGGGGGGGGGGGGGGGGG.G.E..PPPPPPPPPP
PPPPPPPPPPPPPPP..E...GLLLLLGGGGEGGGEGGGLLLLGGGGGGGGGGGGGGGGGGGGG.G.E..PPPPPPPPPP
PPPPPPPPPPPPPPP..E...GLLLLLGGG.E...E.GGLLLLGGGGGGGGGGGGGGGGGGGGG...E..PPPPPPPPPP
PPPPPPPPPPPPPPP..E...GLLLLLGGGCCCCCCGGGLLLLGGGGGGGGGGGGGGGCC...GCCCCCCPPPPPPPPPP
PPPPPPPPPPPPPPP..E...GLLLLLGGGGGGGGGGGGLLLLGGGGGGGGGGGGGGGCCCCCG......PPPPPPPPPP
PPPPPPPPPPPPPPP..E...GLLLLLGGGGGGGGGGGGLLLLGGGGGGGGGGG...GCCCCCG......PPPPPPPPPP
PPPPPPPPPPPPPPP..E...GLLLLLGGGGGGGGGGGGLLLLGGGGGGGGGCCCCCG.....G......PPPPPPPPPP
PPPPPPPPPPPPPPP..E...GLLLLLGGGGGGGGGGGGLLLLGGGG....GCCCCCG.....G......PPPPPPPPPP
PPPPPPPPPPPPPPPCCCCCCGLLLLLGGGGGGGGGGGGLLLLGCCCCCCCG.....G.....G......PPPPPPPPPP
PPPPPPPPPPPPPPPCCCCCCGLLLLLGGGGGGGGGGGGLLLLGCCCCCCCG.....G.....G......PPPPPPPPPP
PPPPPPPPPPPPPPP......GGGGGGGGGGGGGGGGGGGGGGG.......G.....G.....G......PPPPPPPPPP
PPPPPPPPPPPPPPP..CCCCCCCCCCCCCGGGGGGGGCCCCCG.......G.....G.....G......PPPPPPPPPP
PPPPPPPPPPPPPPP...............CCCCCCCC.....C.......C.....C.....C......PPPPPPPPPP
PPPPPPPPPPPPPPP.......................................................PPPPPPPPPP
PPPPPPPPPPPPPPP.......................................................PPPPPPPPPP
PPPPPPPPPPPPPPPPPPPPPPPPPPPPPPPPPPPPPPPPPPPPPPPPPPPPPPPPPPPPPPPPPPPPPPPPPPPPPPPP
PPPPPPPPPPPPPPPPPPPPPPPPPPPPPPPPPPPPPPPPPPPPPPPPPPPPPPPPPPPPPPPPPPPPPPPPPPPPPPPP
PPPPPPPPPPPPPPPPPPPPPPPPPPPPPPPPPPPPPPPPPPPPPPPPPPPPPPPPPPPPPPPPPPPPPPPPPPPPPPPP
