PPPPPPPPPPPPPPPPPPPPPPPPPPPPPPPPPPPPPPPPPPPPPPPPPPPPPPPPPPPPPPPPPPPPPPPPPPPPPPPP
PPPPPPPPPPPPPPPPPPPPPPPPPPPPPPPPPPPPPPPPPPPPPPPPPPPPPPPPPPPPPPPPPPPPPPPPPPPPPPPP
PPPPPPPPPPPPPPPPPPPPPPPPPPPPPPPPPPPPPPPPPPPPPPPPPPPPPPPPPPPPPPPPPPPPPPPPPPPPPPPP
PPPPPPPPPPPPPPPPPPPPPPPPPPPPPPPPPPPPPPPPPPPPPPPPPPPPPPPPPPPPPPPPPPPPPPPPPPPPPPPP
PPPPPPPPPPPPPPPPPPPPPPPPPPPPPPPPPPPPPPPPPPPPPPPPPPPPPPPPPPPPPPPPPPPPPPPPPPPPPPPP
PPPPPPPPPPPPPPPPPPPPPPPPPPPPPPPPPPPPPPPPPPPPPPPPPPPPPPPPPPPPPPPPPPPPPPPPPPPPPPPP
PPPPPPPPPPPPPPPPPPPPPPPPPPPPPPPPPPPPPPPPPPPPPPPPPPPPPPPPPPPPPPPPPPPPPPPPPPPPPPPP
PPPPPPPPPPPPPPPP......................................................PPPPPPPPPP
PPPPPPPPPPPPPPPP......................................................PPPPPPPPPP
PPPPPPPPPPPPPPPP......................................................PPPPPPPPPP
PPPPPPPPPPPPPPPP......................................................PPPPPPPPPP
PPPPPPPPPPPPPPPP......................................................PPPPPPPPPP
PPPPPPPPPPPPPPPP......................................................PPPPPPPPPP
PPPPPPPPPPPPPPPP......................................................PPPPPPPPPP
PPPPPPPPPPPPPPPP......................................................PPPPPPPPPP
PPPPPPPPPPPPPPPP......................................................PPPPPPPPPP
PPPPPPPPPPPPPPPP......................................................PPPPPPPPPP
PPPPPPPPPPPPPPPP......................................................PPPPPPPPPP
PPPPPPPPPPPPPPPP......................................................PPPPPPPPPP
PPPPPPPPPPPPPPPP......................................................PPPPPPPPPP
PPPPPPPPPPPPPPPP......................................................PPPPPPPPPP
PPPPPPPPPPPPPPPP......................................................PPPPPPPPPP
PPPPPPPPPPPPPPPP......................................................PPPPPPPPPP
PPPPPPPPPPPPPPPP......................................................PPPPPPPPPP
PPPPPPPPPPPPPPPP......................................................PPPPPPPPPP
PPPPPPPPPPPPPPPP......................................................PPPPPPPPPP
PPPPPPPPPPPPPPPP......................................................PPPPPPPPPP
PPPPPPPPPPPPPPPP......................................................PPPPPPPPPP
PPPPPPPPPPPPPPPP......................................................PPPPPPPPPP
PPPPPPPPPPPPPPPP......................................................PPPPPPPPPP
PPPPPPPPPPPPPPPP......................................................PPPPPPPPPP
PPPPPPPPPPPPPPPP......................................................PPPPPPPPPP
PPPPPPPPPPPPPPPP......................................................PPPPPPPPPP
PPPPPPPPPPPPPPPP......................................................PPPPPPPPPP
PPPPPPPPPPPPPPPP......................................................PPPPPPPPPP
PPPPPPPPPPPPPPPP......................................................PPPPPPPPPP
PPPPPPPPPPPPPPPP......................................................PPPPPPPPPP
PPPPPPPPPPPPPPPP......................................................PPPPPPPPPP
PPPPPPPPPPPPPPPP......................................................PPPPPPPPPP
PPPPPPPPPPPPPPPP......................................................PPPPPPPPPP
PPPPPPPPPPPPPPPP......................................................PPPPPPPPPP
PPPPPPPPPPPPPPPP......................................................PPPPPPPPPP
PPPPPPPPPPPPPPPP......................................................PPPPPPPPPP
PPPPPPPPPPPPPPPP......................................................PPPPPPPPPP
PPPPPPPPPPPPPPPP......................................................PPPPPPPPPP
PPPPPPPPPPPPPPPP......................................................PPPPPPPPPP
PPPPPPPPPPPPPPPP......................................................PPPPPPPPPP
PPPPPPPPPPPPPPPP......................................................PPPPPPPPPP
PPPPPPPPPPPPPPPP..TCCCCCCCCG..........................................PPPPPPPPPP
PPPPPPPPPPPPPPPP..E........G..........................................PPPPPPPPPP
PPPPPPPPPPPPPPPP..E........G..........................................PPPPPPPPPP
PPPPPPPPPPPPPPPP..E........G..........................................PPPPPPPPPP
PPPPPPPPPPPPPPPP..E........G..........................................PPPPPPPPPP
PPPPPPPPPPPPPPPP..E........G..........................................PPPPPPPPPP
PPPPPPPPPPPPPPPPCCCCCCCCCCCCCCCCCCCCCCCCCCCCCCCCCCCCCCCCCCCCCCCCCCCCCCPPPPPPPPPP
PPPPPPPPPPPPPPPPCCCCCCCCCCCCCCCCCCCCCCCCCCCCCCCCCCCCCCCCCCCCCCCCCCCCCCPPPPPPPPPP
PPPPPPPPPPPPPPPPCCCCCCCCCCCCCCCCCCCCCCCCCCCCCCCCCCCCCCCCCCCCCCCCCCCCCCPPPPPPPPPP
PPPPPPPPPPPPPPPPPPPPPPPPPPPPPPPPPPPPPPPPPPPPPPPPPPPPPPPPPPPPPPPPPPPPPPPPPPPPPPPP
PPPPPPPPPPPPPPPPPPPPPPPPPPPPPPPPPPPPPPPPPPPPPPPPPPPPPPPPPPPPPPPPPPPPPPPPPPPPPPPP
PPPPPPPPPPPPPPPPPPPPPPPPPPPPPPPPPPPPPPPPPPPPPPPPPPPPPPPPPPPPPPPPPPPPPPPPPPPPPPPP
