PPPPPPPPPPPPPPPPPPPPPPPPPPPPPPPPPPPPPPPPPPPPPPPPPPPPPPPPPPPPPPPPPPPPPPPPPPPPPPPP
PPPPPPPPPPPPPPPPPPPPPPPPPPPPPPPPPPPPPPPPPPPPPPPPPPPPPPPPPPPPPPPPPPPPPPPPPPPPPPPP
PPPPPPPPPPPPPPPPPPPPPPPPPPPPPPPPPPPPPPPPPPPPPPPPPPPPPPPPPPPPPPPPPPPPPPPPPPPPPPPP
PPPPPPPPPPPPPPPPPPPPPPPPPPPPPPPPPPPPPPPPPPPPPPPPPPPPPPPPPPPPPPPPPPPPPPPPPPPPPPPP
PPPPPPPPPPPPPPPPPPPPPPPPPPPPPPPPPPPPPPPPPPPPPPPPPPPPPPPPPPPPPPPPPPPPPPPPPPPPPPPP
PPPPPPPPPPPPPPPPPPPPPPPPPPPPPPPPPPPPPPPPPPPPPPPPPPPPPPPPPPPPPPPPPPPPPPPPPPPPPPPP
PPPPPPPPPPPPPPPPPPPPPPPPPPPPPPPPPPPPPPPPPPPPPPPPPPPPPPPPPPPPPPPPPPPPPPPPPPPPPPPP
PPPPPPPPPPPPPPPP............................VVVV......................PPPPPPPPPP
PPPPPPPPPPPPPPPP............................VVVV......................PPPPPPPPPP
PPPPPPPPPPPPPPPP............................VVVV......................PPPPPPPPPP
PPPPPPPPPPPPPPPPPPPPPPPPPPPPPPPPPPPPPCCCCCCCVVVV......................PPPPPPPPPP
PPPPPPPPPPPPPPPPPPPPPPPPPPPPPPPPPPPPP..........T......................PPPPPPPPPP
PPPPPPPPPPPPPPPPPPPPPPPPPPPPPPPPPPPPP..........E......................PPPPPPPPPP
PPPPPPPPPPPPPPPPPPPPPPPPPPPPPPPPPPPPP..........E......................PPPPPPPPPP
PPPPPPPPPPPPPPPPPPPPPPPPPPPPPPPPPPPPP..........E......................PPPPPPPPPP
PPPPPPPPPPPPPPPPPPPPPPPPPPPPPPPPPPPPP..........E......................PPPPPPPPPP
PPPPPPPPPPPPPPPPPPPPPPPPPPPPPPPPPPPPPCCCCCCCCCCECC....................PPPPPPPPPP
PPPPPPPPPPPPPPPPPPPPPPPPPPPPPPPPPPPPPCCCCCCCCCCCCCCCCCCCCCCCCCCCCCCGGGPPPPPPPPPP
PPPPPPPPPPPPPPPPP....................ECCCCCCCCCCCCCCCCCCCCCCCTCCCCCGGGPPPPPPPPPP
PPPPPPPPPPPPPPPPP............................................E.....GGGPPPPPPPPPP
PPPPPPPPPPPPPPPPP............................................E.....GGGPPPPPPPPPP
PPPPPPPPPPPPPPPPP............................................E.....GGGPPPPPPPPPP
PPPPPPPPPPPPPPPPP....................E.......................E.....CCCPPPPPPPPPP
PPPPPPPPPPPPPPPPP....................E...............CCCCCCCCCCCCCCCCCPPPPPPPPPP
PPPPPPPPPPPPPPPPP........CCCCCCCCCCCCCCCCCCCCCCCCCCCCCCCCCCCCCCCCCCCCCPPPPPPPPPP
PPPPPPPPPPPPPPPPPGCCCCCCCCCCCCCCCTCCCCCCCCCCCCCCCCCCCCCCCCCCCCCCCCCCCCPPPPPPPPPP
PPPPPPPPPPPPPPPPPG.....T.........E.......................E............PPPPPPPPPP
PPPPPPPPPPPPPPPPPG.....E.........E....................................PPPPPPPPPP
PPPPPPPPPPPPPPPPPG.....E.........E....................................PPPPPPPPPP
PPPPPPPPPPPPPPPPPG.....E.........E....................................PPPPPPPPPP
PPPPPPPPPPPPPPPPPC.....E.........E.......................E............PPPPPPPPPP
PPPPPPPPPPPPPPPPPCCCCCCCCCCCCCCCCCCCCCCCCCCCCCCC.........E............PPPPPPPPPP
PPPPPPPPPPPPPPPPPCCCCCCCCCCCCCCCCCCCCCCCCCCTCCCCCCCCCCCCCCCCCCCCCCCGGGPPPPPPPPPP
PPPPPPPPPPPPPPPPP..............E...........E...CCCCCCCCCCCCCCTCCCCCGGGPPPPPPPPPP
PPPPPPPPPPPPPPPPP..........................E.................E.....GGGPPPPPPPPPP
PPPPPPPPPPPPPPPPP..........................E.................E.....GGGPPPPPPPPPP
PPPPPPPPPPPPPPPPP..........................E.................E.....GGGPPPPPPPPPP
PPPPPPPPPPPPPPPPP..............E...........E.................E.....CCCPPPPPPPPPP
PPPPPPPPPPPPPPPPP..............E...........E.........CCCCCCCCCCCCCCCCPPPPPPPPPPP
PPPPPPPPPPPPPPPPP............CCCCCCCCCCCCCCCCCCCCCCCCCCCCCCCCCCCCCCCCCPPPPPPPPPP
PPPPPPPPPPPPPPPPPGCCCCCCCCCCCCCCCCCCCCCTCCCCCCCCCCCCCCCCCCCCCCCCCCCCCCPPPPPPPPPP
PPPPPPPPPPPPPPPPPGCCCCCTCCCCCCCCCCCCCCCE..............................PPPPPPPPPP
PPPPPPPPPPPPPPPPPG.....E...............E..............................PPPPPPPPPP
PPPPPPPPPPPPPPPPPG.....E...............E..............................PPPPPPPPPP
PPPPPPPPPPPPPPPPPG.....E...............E..............................PPPPPPPPPP
PPPPPPPPPPPPPPPPPC.....E...............E..............................PPPPPPPPPP
PPPPPPPPPPPPPPPPPCCCCCCCCCCCCCCCCCCCCCCCCCCC..........................PPPPPPPPPP
PPPPPPPPPPPPPPPPPCCCCCCCCCCCCCCCCCCCCCCCCCCCCCCCCCCCCCCCCCCCCCCCCCCGGGPPPPPPPPPP
PPPPPPPPPPPPPPPPP..................E........CCCCCCCCCCCCCCCCCTCCCCCGGGPPPPPPPPPP
PPPPPPPPPPPPPPPPP............................................E.....GGGPPPPPPPPPP
PPPPPPPPPPPPPPPPP............................................E.....GGGPPPPPPPPPP
PPPPPPPPPPPPPPPPP............................................E.....GGGPPPPPPPPPP
PPPPPPPPPPPPPPPPP..................E.........................E.....CCCPPPPPPPPPP
PPPPPPPPPPPPPPPPP..................E.......................CCCCCCCCCCCPPPPPPPPPP
PPPPPPPPPPPPPPPPPCCCCCCCCCCCCCCCCCCCCCCCCCCCCCCCCCCCCCCCCCCCCCCCCCCCCCPPPPPPPPPP
PPPPPPPPPPPPPPPPPCCCCCCCCCCCCCCCCCCCCCCCCCCCCCCCCCCCCCCCCCCCCCCCCCCCCCPPPPPPPPPP
PPPPPPPPPPPPPPPPPCCCCCCCCCCCCCCCCCCCCCCCCCCCCCCCCCCCCCCCCCCCCCCCCCCCCCPPPPPPPPPP
PPPPPPPPPPPPPPPPPPPPPPPPPPPPPPPPPPPPPPPPPPPPPPPPPPPPPPPPPPPPPPPPPPPPPPPPPPPPPPPP
PPPPPPPPPPPPPPPPPPPPPPPPPPPPPPPPPPPPPPPPPPPPPPPPPPPPPPPPPPPPPPPPPPPPPPPPPPPPPPPP
PPPPPPPPPPPPPPPPPPPPPPPPPPPPPPPPPPPPPPPPPPPPPPPPPPPPPPPPPPPPPPPPPPPPPPPPPPPPPPPP
