PPPPPPPPPPPPPPPPPPPPPPPPPPPPPPPPPPPPPPPPPPPPPPPPPPPPPPPPPPPPPPPPPPPPPPPPPPPPPPPP
PPPPPPPPPPPPPPPPPPPPPPPPPPPPPPPPPPPPPPPPPPPPPPPPPPPPPPPPPPPPPPPPPPPPPPPPPPPPPPPP
PPPPPPPPPPPPPPPPPPPPPPPPPPPPPPPPPPPPPPPPPPPPPPPPPPPPPPPPPPPPPPPPPPPPPPPPPPPPPPPP
PPPPPPPPPPPPPPPPPPPPPPPPPPPPPPPPPPPPPPPPPPPPPPPPPPPPPPPPPPPPPPPPPPPPPPPPPPPPPPPP
PPPPPPPPPPPPPPPPPPPPPPPPPPPPPPPPPPPPPPPPPPPPPPPPPPPPPPPPPPPPPPPPPPPPPPPPPPPPPPPP
PPPPPPPPPPPPPPPPPPPPPPPPPPPPPPPPPPPPPPPPPPPPPPPPPPPPPPPPPPPPPPPPPPPPPPPPPPPPPPPP
PPPPPPPPPPPPPPPPPPPPPPPPPPPPPPPPPPPPPPPPPPPPPPPPPPPPPPPPPPPPPPPPPPPPPPPPPPPPPPPP
PPPPPPPPPPPPPPPP............................VVVV......................PPPPPPPPPP
PPPPPPPPPPPPPPPP............................VVVV......................PPPPPPPPPP
PPPPPPPPPPPPPPPP............................VVVV......................PPPPPPPPPP
PPPPPPPPPPPPPPPP............................VVVV......................PPPPPPPPPP
PPPPPPPPPPPPPPPPPPPPPPPPPPPPPPPPPPPPPCCCCCCCCCCTC.....................PPPPPPPPPP
PPPPPPPPPPPPPPPPPPPPPPPPPPPPPPPPPPPPP..........E......................PPPPPPPPPP
PPPPPPPPPPPPPPPPPPPPPPPPPPPPPPPPPPPPP..........E......................PPPPPPPPPP
PPPPPPPPPPPPPPPPPPPPPPPPPPPPPPPPPPPPP..........E......................PPPPPPPPPP
PPPPPPPPPPPPPPPPPPPPPPPPPPPPPPPPPPPPP..........E......................PPPPPPPPPP
PPPPPPPPPPPPPPPPPPPPPPPPPPPPPPPPPPPPPCCCCCCCCCCECCCCCCCCCCCCCCCCCCCCCCPPPPPPPPPP
PPPPPPPPPPP..................................................................PPP
PPPPPPPPPPP..................................................................PPP
PPPPPPPPPPP..................................................................PPP
PPPPPPPPPPP..................................................................PPP
PPPPPPPPPPP..................................................................PPP
PPPPPPPPPPPCCCCCCCCCCCCGGGGGGGGG.............................................PPP
PPPPPPPPPPPCCCCCTCCCCCCGGGGGGGGG.............................................PPP
PPPPPPPPPPP.....E......GGGGGGGGG.............................................PPP
PPPPPPPPPPP.....E......GGGGGGGGG.............................................PPP
PPPPPPPPPPP.....E......GGGGGGGGG.............................................PPP
PPPPPPPPPPP.....E......GGGGGGGGG..CCCCCG.....................................PPP
PPPPPPPPPPP.....E......GGGGGGGGG..T....G.....................................PPP
PPPPPPPPPPP.....E......GGGGGGGGG..E....G.....................................PPP
PPPPPPPPPPP.....E......GGGGGGGGG..E....G.....................................PPP
PPPPPPPPPPP.....E......GGGGGGGGG..E....G.....................................PPP
PPPPPPPPPPP.....E......GGGGGGGGG..E....G.....................................PPP
PPPPPPPPPPPCCCCCCCCCCCCGGGGGGGGG..E....G.....................................PPP
PPPPPPPPPPP..........T.GGGGGGGGG..E....G.....................................PPP
PPPPPPPPPPP..........E.GGGGGGGGG..E....G.....................................PPP
PPPPPPPPPPP..........E.GGGGGGGGG..E....G.....................................PPP
PPPPPPPPPPP..........E.GGGGGGGGG..E..........................................PPP
PPPPPPPPPPP..........E.GGGGGGGGGCCCCCCCGGGGGCCCGGGGGGCCCCGGGCCCCCCGGGGCCCCCGGPPP
PPPPPPPPPPP..........E.GGGGGGGGG.......GGGGG...GGGGGG....GGG......GGGG.....GGPPP
PPPPPPPPPPP..........E.GGGGGGGGG.......GGGGG...GGGGGG....GGG......GGGG.....GGPPP
PPPPPPPPPPP..........E.GGGGGGGGG.......GGGGG...GGGGGG....GGG......GGGG.....GGPPP
PPPPPPPPPPP..........E.GGGGGGGGG.......GGGGG...GGGGGG....GGG......GGGG.....GGPPP
PPPPPPPPPPPCCCCCCCCCCCCGGGGGGGGG.......GGGGG...GGGGGG....GGG......GGGG.....GGPPP
PPPPPPPPPPPCCCCCCCCCCCCGGGGGGGGG.......GGGGG...GGGGGG....GGG......GGGG.....GGPPP
PPPPPPPPPPP............GGGGGGGGG.......GGGGG...GGGGGG....GGG......GGGG.....GGPPP
PPPPPPPPPPP............GGGGGGGGG.......GGGGG...GGGGGG....GGG......GGGG.....GGPPP
PPPPPPPPPPP............GGGGGGGGG.......GGGGG...GGGGGG....GGG......GGGG.....GGPPP
PPPPPPPPPPP............GGGGGGGGGGGGGGGGGGGGGGGGGGGGGGGGGGGGGCCCCCCCCCCCCCCCCCPPP
PPPPPPPPPPP............GGGGGGGGGGGGGGGGGGGGGGGGGGGGGGGGGGGGG..T............T.PPP
PPPPPPPPPPP............GGGGGGGGGGGGGGGGGGGGGGGGGGGGGGGGGGGGG..E............E.PPP
PPPPPPPPPPP............GGGGGGGGGGGGGGGGGGGGGGGGGGGGGGGGGGGGG..E............E.PPP
PPPPPPPPPPP............GGGGGGGGGGGGGGGGGGGGGGGGGGGGGGGGGGGGG..E............E.PPP
PPPPPPPPPPP............GGGGGGGGGGGGGGGGGGGGGGGGGGGGGGGGGGGGG..E............E.PPP
PPPPPPPPPPP............GGGGGGGGGGGGGGGGGGGGGGGGGGGGGGGGGGGGG..E............E.PPP
PPPPPPPPPPPCCCCCCCCCGGGGGGGGGGGGCCCCCCCCCCCCCCCCCCCCCCCCCCCCCCCCCCCCCCCCCCCCCPPP
PPPPPPPPPPP.........GGGGGGGGGGGGCCCCCCCCCCCCCCCCCCCCCCCCCCCCCCCCCCCCCCCCCCCCCPPP
PPPPPPPPPPP.........GGGGGGGGGGGG...........................................PPPPP
PPPPPPPPPPPPPPPPPPPPCCCCCCCCCCPPPPPPPPPPPPPPPPPPPPPPPPPPPPPPPPPPPPPPPPPPPPPPPPPP
PPPPPPPPPPPPPPPPPPPPPPPPPPPPPPPPPPPPPPPPPPPPPPPPPPPPPPPPPPPPPPPPPPPPPPPPPPPPPPPP