PPPPPPPPPPPPPPPPPPPPPPPPPPPPPPPPPPPPPPPPPPPPPPPPPPPPPPPPPPPPPPPPPPPPPPPPPPPPPPPP
PPPPPPPPPPPPPPPPPPPPPPPPPPPPPPPPPPPPPPPPPPPPPPPPPPPPPPPPPPPPPPPPPPPPPPPPPPPPPPPP
PPPPPPPPPPPPPPPPPPPPPPPPPPPPPPPPPPPPPPPPPPPPPPPPPPPPPPPPPPPPPPPPPPPPPPPPPPPPPPPP
PPPPPPPPPPPPPPPPPPPPPPPPPPPPPPPPPPPPPPPPPPPPPPPPPPPPPPPPPPPPPPPPPPPPPPPPPPPPPPPP
PPPPPPPPPPPPPPPPPPPPPPPPPPPPPPPPPPPPPPPPPPPPPPPPPPPPPPPPPPPPPPPPPPPPPPPPPPPPPPPP
PPPPPPPPPPPPPPPPPPPPPPPPPPPPPPPPPPPPPPPPPPPPPPPPPPPPPPPPPPPPPPPPPPPPPPPPPPPPPPPP
PPPPPPPPPPPPPPPPPPPPPPPPPPPPPPPPPPPPPPPPPPPPPPPPPPPPPPPPPPPPPPPPPPPPPPPPPPPPPPPP
PPPPPPPPPPPPPPPP............................VVVV......................PPPPPPPPPP
PPPPPPPPPPPPPPPP............................VVVV......................PPPPPPPPPP
PPPPPPPPPPPPPPPP............................VVVV......................PPPPPPPPPP
PPPPPPPPPPPPPPPPPPPPPPPPPPPPPPPPPPPPPCCCCCCCVVVV......................PPPPPPPPPP
PPPPPPPPPPPPPPPPPPPPPPPPPPPPPPPPPPPPP..........T......................PPPPPPPPPP
PPPPPPPPPPPPPPPPPPPPPPPPPPPPPPPPPPPPP..........E......................PPPPPPPPPP
PPPPPPPPPPPPPPPPPPPPPPPPPPPPPPPPPPPPP..........E......................PPPPPPPPPP
PPPPPPPPPPPPPPPPPPPPPPPPPPPPPPPPPPPPP..........E......................PPPPPPPPPP
PPPPPPPPPPPPPPPPPPPPPPPPPPPPPPPPPPPPP..........E......................PPPPPPPPPP
PPPPPPPPPPPPPPPPPPPPPPPPPPPPPPPPPPPPPCCCCCCCCCCECC....................PPPPPPPPPP
PPPPPPPPPPPPPPPPPPPPPPPPPPPPPPPPPPPPPCCCCCCCCCCCCCCCCCCCCCCCCCCCCCCGGGPPPPPPPPPP
PPPPPPPPPPPPPPPP.....................ECCCCCCCCCCCCCCCCCCCCCCCTCCCCCGGGPPPPPPPPPP
PPPPPPPPPPPPPPPP.............................................E.....GGGPPPPPPPPPP
PPPPPPPPPPPPPPPP.............................................E.....GGGPPPPPPPPPP
PPPPPPPPPPPPPPPP.............................................E.....GGGPPPPPPPPPP
PPPPPPPPPPPPPPPP.....................E.......................E.....CCCPPPPPPPPPP
PPPPPPPPPPPPPPPP.....................E...............CCCCCCCCCCCCCCCCCPPPPPPPPPP
PPPPPPPPPPPPPPPP.........CCCCCCCCCCCCCCCCCCCCCCCCCCCCCCCCCCCCCCCCCCCCCPPPPPPPPPP
PPPPPPPPPPPPPPPPGGCCCCCCCCCCCCCCCTCCCCCCCCCCCCCCCCCCCCCCCCCCCCCCCCCCCCPPPPPPPPPP
PPPPPPPPPPPPPPPPGG.....T.........E.......................E............PPPPPPPPPP
PPPPPPPPPPPPPPPPGG.....E.........E....................................PPPPPPPPPP
PPPPPPPPPPPPPPPPGG.....E.........E....................................PPPPPPPPPP
PPPPPPPPPPPPPPPPGG.....E.........E....................................PPPPPPPPPP
PPPPPPPPPPPPPPPPCC.....E.........E.......................E............PPPPPPPPPP
PPPPPPPPPPPPPPPPCCCCCCCCCCCCCCCCCCCCCCCCCCCCCCCC.........E............PPPPPPPPPP
PPPPPPPPPPPPPPPPCCCCCCCCCCCCCCCCCCCCCCCCCCCTCCCCCCCCCCCCCCCCCCCCCCCGGGPPPPPPPPPP
PPPPPPPPPPPPPPPP...............E...........E...CCCCCCCCCCCCCCTCCCCCGGGPPPPPPPPPP
PPPPPPPPPPPPPPPP...........................E.................E.....GGGPPPPPPPPPP
PPPPPPPPPPPPPPPP...........................E.................E.....GGGPPPPPPPPPP
PPPPPPPPPPPPPPPP...........................E.................E.....GGGPPPPPPPPPP
PPPPPPPPPPPPPPPP...............E...........E.................E.....CCCPPPPPPPPPP
PPPPPPPPPPPPPPPP...............E...........E.........CCCCCCCCCCCCCCCCPPPPPPPPPPP
PPPPPPPPPPPPPPPP.............CCCCCCCCCCCCCCCCCCCCCCCCCCCCCCCCCCCCCCCCCPPPPPPPPPP
PPPPPPPPPPPPPPPPGGCCCCCCCCCCCCCCCCCCCCCTCCCCCCCCCCCCCCCCCCCCCCCCCCCCCCPPPPPPPPPP
PPPPPPPPPPPPPPPPGGCCCCCTCCCCCCCCCCCCCCCE..............................PPPPPPPPPP
PPPPPPPPPPPPPPPPGG.....E...............E..............................PPPPPPPPPP
PPPPPPPPPPPPPPPPGG.....E...............E..............................PPPPPPPPPP
PPPPPPPPPPPPPPPPGG.....E...............E..............................PPPPPPPPPP
PPPPPPPPPPPPPPPPCC.....E...............E..............................PPPPPPPPPP
PPPPPPPPPPPPPPPPCCCCCCCCCCCCCCCCCCCCCCCCCCCC..........................PPPPPPPPPP
PPPPPPPPPPPPPPPPCCCCCCCCCCCCCCCCCCCCCCCCCCCCCCCCCCCCCCCCCCCCCCCCCCCGGGPPPPPPPPPP
PPPPPPPPPPPPPPPP...................E........CCCCCCCCCCCCCCCCCTCCCCCGGGPPPPPPPPPP
PPPPPPPPPPPPPPPP.............................................E.....GGGPPPPPPPPPP
PPPPPPPPPPPPPPPP.............................................E.....GGGPPPPPPPPPP
PPPPPPPPPPPPPPPP.............................................E.....GGGPPPPPPPPPP
PPPPPPPPPPPPPPPP...................E.........................E.....CCCPPPPPPPPPP
PPPPPPPPPPPPPPPP...................E.......................CCCCCCCCCCCPPPPPPPPPP
PPPPPPPPPPPPPPPPCCCCCCCCCCCCCCCCCCCCCCCCCCCCCCCCCCCCCCCCCCCCCCCCCCCCCCPPPPPPPPPP
PPPPPPPPPPPPPPPPCCCCCCCCCCCCCCCCCCCCCCCCCCCCCCCCCCCCCCCCCCCCCCCCCCCCCCPPPPPPPPPP
PPPPPPPPPPPPPPPPCCCCCCCCCCCCCCCCCCCCCCCCCCCCCCCCCCCCCCCCCCCCCCCCCCCCCCPPPPPPPPPP
PPPPPPPPPPPPPPPPPPPPPPPPPPPPPPPPPPPPPPPPPPPPPPPPPPPPPPPPPPPPPPPPPPPPPPPPPPPPPPPP
PPPPPPPPPPPPPPPPPPPPPPPPPPPPPPPPPPPPPPPPPPPPPPPPPPPPPPPPPPPPPPPPPPPPPPPPPPPPPPPP
PPPPPPPPPPPPPPPPPPPPPPPPPPPPPPPPPPPPPPPPPPPPPPPPPPPPPPPPPPPPPPPPPPPPPPPPPPPPPPPP
