PPPPPPPPPPPPPPPPPPPPPPPPPPPPPPPPPPPPPPPPPPPPPPPPPPPPPPPPPPPPPPPPPPPPPPPPPPPPPPPP
PPPPPPPPPPPPPPPPPPPPPPPPPPPPPPPPPPPPPPPPPPPPPPPPPPPPPPPPPPPPPPPPPPPPPPPPPPPPPPPP
PPPPPPPPPPPPPPPPPPPPPPPPPPPPPPPPPPPPPPPPPPPPPPPPPPPPPPPPPPPPPPPPPPPPPPPPPPPPPPPP
PPPPPPPPPPPPPPPPPPPPPPPPPPPPPPPPPPPPPPPPPPPPPPPPPPPPPPPPPPPPPPPPPPPPPPPPPPPPPPPP
PPPPPPPPPPPPPPPPPPPPPPPPPPPPPPPPPPPPPPPPPPPPPPPPPPPPPPPPPPPPPPPPPPPPPPPPPPPPPPPP
PPPPPPPPPPPPPPPPPPPPPPPPPPPPPPPPPPPPPPPPPPPPPPPPPPPPPPPPPPPPPPPPPPPPPPPPPPPPPPPP
PPPPPPPPPPPPPPPPPPPPPPPPPPPPPPPPPPPPPPPPPPPPPPPPPPPPPPPPPPPPPPPPPPPPPPPPPPPPPPPP
PPPPPPPPPPPPPPPP............................VVVV.............................PPP
PPPPPPPPPPPPPPPP............................VVVV.............................PPP
PPPPPPPPPPPPPPPP............................VVVV.............................PPP
PPPPPPPPPPPPPPPP............................VVVV.............................PPP
PPPPPPPPPPPPPPPPPPPPPPPPPPPPPPPPPPPPPCCCCCCCCCCTC............................PPP
PPPPPPPPPPPPPPPPPPPPPPPPPPPPPPPPPPPPP..........E.............................PPP
PPPPPPPPPPPPPPPPPPPPPPPPPPPPPPPPPPPPP..........E.............................PPP
PPPPPPPPPPPPPPPPPPPPPPPPPPPPPPPPPPPPP..........E.............................PPP
PPPPPPPPPPPPPPPPPPPPPPPPPPPPPPPPPPPPP..........E.............................PPP
PPPPPPPPPPPPPPPPPPPPPPPPPPPPPPPPPPPPPCCCCCCCCCCECCCCCCCCCCCCCCCCCCCCCCCCCCCGGPPP
PPPPPPPPPPP............GGGGGGGGG........................................T..GGPPP
PPPPPPPPPPP............GGGGGGGGG........................................E..GGPPP
PPPPPPPPPPP............GGGGGGGGG........................................E..GGPPP
PPPPPPPPPPP............GGGGGGGGG........................................E..GGPPP
PPPPPPPPPPP............GGGGGGGGG........................................E..GGPPP
PPPPPPPPPPPCCCCCCCCCCCCGGGGGGGGG........................................E..GGPPP
PPPPPPPPPPPCCCCCTCCCCCCGGGGGGGGG........................................E..GGPPP
PPPPPPPPPPP.....E......GGGGGGGGG........................................E..GGPPP
PPPPPPPPPPP.....E......GGGGGGGGG........................................E..GGPPP
PPPPPPPPPPP.....E......GGGGGGGGG........................................E..GGPPP
PPPPPPPPPPP.....E......GGGGGGGGGGGCCCCCGGCCCCCCGGCCCCCCGGCCCCCCGGCCCCCCCECCGGPPP
PPPPPPPPPPP.....E......GGGGGGGGGGGTCCCCGGCCCCCCGGCCCCCCGGCCCCCCGGCCCCCCCCCCGGPPP
PPPPPPPPPPP.....E......GGGGGGGGGGGE....GG......GG......GG......GG..........GGPPP
PPPPPPPPPPP.....E......GGGGGGGGGGGE....GG......GG......GG......GG..........GGPPP
PPPPPPPPPPP.....E......GGGGGGGGGGGE....GG......GG......GG......GG..........GGPPP
PPPPPPPPPPP.....E......GGGGGGGGGGGE....GG......GG......GG......GG..........GGPPP
PPPPPPPPPPPCCCCCCCCCCCCGGGGGGGGGGGE....GG......GG......GG......GG..........GGPPP
PPPPPPPPPPP..........T.GGGGGGGGGGGE....GG......GG......GG......GG..........GGPPP
PPPPPPPPPPP..........E.GGGGGGGGGGGE....GG......GG......GG......GG..........GGPPP
PPPPPPPPPPP..........E.GGGGGGGGGGGE....GG......GG......GG......GG..........GGPPP
PPPPPPPPPPP..........E.GGGGGGGGG..E........................................GGPPP
PPPPPPPPPPP..........E.GGGGGGGGGCCCCCCCGGGGGCCCGGGGGGCCCCGGGCCCCCCGGGGCCCCCGGPPP
PPPPPPPPPPP..........E.GGGGGGGGG.......GGGGG...GGGGGG....GGG......GGGG.....GGPPP
PPPPPPPPPPP..........E.GGGGGGGGG.......GGGGG...GGGGGG....GGG......GGGG.....GGPPP
PPPPPPPPPPP..........E.GGGGGGGGG.......GGGGG...GGGGGG....GGG......GGGG.....GGPPP
PPPPPPPPPPP..........E.GGGGGGGGG.......GGGGG...GGGGGG....GGG......GGGG.....GGPPP
PPPPPPPPPPPCCCCCCCCCCCCGGGGGGGGG.......GGGGG...GGGGGG....GGG......GGGG.....GGPPP
PPPPPPPPPPPCCCCCCCCCCCCGGGGGGGGG.......GGGGG...GGGGGG....GGG......GGGG.....GGPPP
PPPPPPPPPPP............GGGGGGGGG.......GGGGG...GGGGGG....GGG......GGGG.....GGPPP
PPPPPPPPPPP............GGGGGGGGG.......GGGGG...GGGGGG....GGG......GGGG.....GGPPP
PPPPPPPPPPP............GGGGGGGGG.......GGGGG...GGGGGG....GGG......GGGG.....GGPPP
PPPPPPPPPPP............GGGGGGGGGGGGGGGGGGGGGGGGGGGGGGGGGGGGGCCCCCCCCCCCCCCCCCPPP
PPPPPPPPPPP............GGGGGGGGGGGGGGGGGGGGGGGGGGGGGGGGGGGGG..T............T.PPP
PPPPPPPPPPP............GGGGGGGGGGGGGGGGGGGGGGGGGGGGGGGGGGGGG..E............E.PPP
PPPPPPPPPPP............GGGGGGGGGGGGGGGGGGGGGGGGGGGGGGGGGGGGG..E............E.PPP
PPPPPPPPPPP............GGGGGGGGGGGGGGGGGGGGGGGGGGGGGGGGGGGGG..E............E.PPP
PPPPPPPPPPP............GGGGGGGGGGGGGGGGGGGGGGGGGGGGGGGGGGGGG..E............E.PPP
PPPPPPPPPPP............GGGGGGGGGGGGGGGGGGGGGGGGGGGGGGGGGGGGG..E............E.PPP
PPPPPPPPPPPCCCCCCCCCGGGGGGGGGGGGCCCCCCCCCCCCCCCCCCCCCCCCCCCCCCCCCCCCCCCCCCCCCPPP
PPPPPPPPPPP.........GGGGGGGGGGGGCCCCCCCCCCCCCCCCCCCCCCCCCCCCCCCCCCCCCCCCCCCCCPPP
PPPPPPPPPPP.........GGGGGGGGGGGG...........................................PPPPP
PPPPPPPPPPPPPPPPPPPPCCCCCCCCCCPPPPPPPPPPPPPPPPPPPPPPPPPPPPPPPPPPPPPPPPPPPPPPPPPP
PPPPPPPPPPPPPPPPPPPPPPPPPPPPPPPPPPPPPPPPPPPPPPPPPPPPPPPPPPPPPPPPPPPPPPPPPPPPPPPP