PPPPPPPPPPPPPPPPPPPPPPPPPPPPPPPPPPPPPPPPPPPPPPPPPPPPPPPPPPPPPPPPPPPPPPPPPPPPPPPP
PPPPPPPPPPPPPPPPPPPPPPPPPPPPPPPPPPPPPPPPPPPPPPPPPPPPPPPPPPPPPPPPPPPPPPPPPPPPPPPP
PPPPPPPPPPPPPPPPPPPPPPPPPPPPPPPPPPPPPPPPPPPPPPPPPPPPPPPPPPPPPPPPPPPPPPPPPPPPPPPP
PPPPPPPPPPPPPPPPPPPPPPPPPPPPPPPPPPPPPPPPPPPPPPPPPPPPPPPPPPPPPPPPPPPPPPPPPPPPPPPP
PPPPPPPPPPPPPPPPPPPPPPPPPPPPPPPPPPPPPPPPPPPPPPPPPPPPPPPPPPPPPPPPPPPPPPPPPPPPPPPP
PPPPPPPPPPPPPPPPPPPPPPPPPPPPPPPPPPPPPPPPPPPPPPPPPPPPPPPPPPPPPPPPPPPPPPPPPPPPPPPP
PPPPPPPPPPPPPPPPPPPPPPPPPPPPPPPPPPPPPPPPPPPPPPPPPPPPPPPPPPPPPPPPPPPPPPPPPPPPPPPP
PPPPPPPPPPPPPPPP............................VVVV......................PPPPPPPPPP
PPPPPPPPPPPPPPPP............................VVVV......................PPPPPPPPPP
PPPPPPPPPPPPPPPP............................VVVV......................PPPPPPPPPP
PPPPPPPPPPPPPPPP............................VVVV......................PPPPPPPPPP
PPPPPPPPPPPPPPPPPPPPPPPPPPPPPPPPPPPPPCCCCCCCCCCC......................PPPPPPPPPP
PPPPPPPPPPPPPPPPPPPPPPPPPPPPPPPPPPPPP..........T......................PPPPPPPPPP
PPPPPPPPPPPPPPPPPPPPPPPPPPPPPPPPPPPPP..........E......................PPPPPPPPPP
PPPPPPPPPPPPPPPPPPPPPPPPPPPPPPPPPPPPP..........E......................PPPPPPPPPP
PPPPPPPPPPPPPPPPPPPPPPPPPPPPPPPPPPPPP..........E......................PPPPPPPPPP
PPPPPPPPPPPPPPPPPPPPPPPPPPPPPPPPPPPPPCCCCA.....E......................PPPPPPPPPP
PPPPPPPPPPPPPPPPPPPPPPPPPPPPPPPPPPPPPCCCCACCCCCCCACCCCCACCCCCCCCCCC...PPPPPPPPPP
PPPPPPPPPPPPPPPP.....................E.......................T........PPPPPPPPPP
PPPPPPPPPPPPPPPP.............................................E........PPPPPPPPPP
PPPPPPPPPPPPPPPP.............................................E........PPPPPPPPPP
PPPPPPPPPPPPPPPP.............................................E........PPPPPPPPPP
PPPPPPPPPPPPPPPP.....................E.......................E........PPPPPPPPPP
PPPPPPPPPPPPPPPP.....................E...............DCCCCCDCCCCCCCCCCPPPPPPPPPP
PPPPPPPPPPPPPPPP.........DCCCCDCCCCDCCCCDCCCCCCCDCCCCDCCCCCDCCCCCCCCCCPPPPPPPPPP
PPPPPPPPPPPPPPPP..CCCCCCCDCCCCDCCTCDCCCCDCCCCCCCDCCCCCCCCCCCCCCCCCCCCCPPPPPPPPPP
PPPPPPPPPPPPPPPP.......T.........E.......................E............PPPPPPPPPP
PPPPPPPPPPPPPPPP.......E.........E....................................PPPPPPPPPP
PPPPPPPPPPPPPPPP.......E.........E....................................PPPPPPPPPP
PPPPPPPPPPPPPPPP.......E.........E....................................PPPPPPPPPP
PPPPPPPPPPPPPPPP.......E.........E.......................E............PPPPPPPPPP
PPPPPPPPPPPPPPPPCCCCCCCCACCCCACCCCCCCCCCCCCCCCCA.........E............PPPPPPPPPP
PPPPPPPPPPPPPPPPCCCCCCCCACCCCACCCCCCCCCCCCCTCCCAACCCCAACCCCCCCCCCCC...PPPPPPPPPP
PPPPPPPPPPPPPPPP...............E...........E...AACCCCAACCCCCCTCCCCC...PPPPPPPPPP
PPPPPPPPPPPPPPPP...........................E.................E........PPPPPPPPPP
PPPPPPPPPPPPPPPP...........................E.................E........PPPPPPPPPP
PPPPPPPPPPPPPPPP...........................E.................E........PPPPPPPPPP
PPPPPPPPPPPPPPPP...............E...........E.................E........PPPPPPPPPP
PPPPPPPPPPPPPPPP...............E...........E.........DCCCCCDCCCCCCCCCPPPPPPPPPPP
PPPPPPPPPPPPPPPP.............DCCCCCCCCCCCCCCCCCDDCCCCDCCCCCDCCCCCCCCCCPPPPPPPPPP
PPPPPPPPPPPPPPPP..CCCCCCCCCCCDCCCCCCCCCTCCCCCCCDDCCCCDCCCCCDCCCCCCCCCCPPPPPPPPPP
PPPPPPPPPPPPPPPP..CCCCCTCCCCCDCCCCCCCCCE..............................PPPPPPPPPP
PPPPPPPPPPPPPPPP.......E...............E..............................PPPPPPPPPP
PPPPPPPPPPPPPPPP.......E...............E..............................PPPPPPPPPP
PPPPPPPPPPPPPPPP.......E...............E..............................PPPPPPPPPP
PPPPPPPPPPPPPPPP.......E...............E..............................PPPPPPPPPP
PPPPPPPPPPPPPPPPCCCACCCCCACCCCCACCCCCACCCCCA..........................PPPPPPPPPP
PPPPPPPPPPPPPPPPCCCACCCCCACCCCCACCCCCACCCCCACCCCCACCCCCACCCACCCCCCC...PPPPPPPPPP
PPPPPPPPPPPPPPPP...................E.........................T........PPPPPPPPPP
PPPPPPPPPPPPPPPP.............................................E........PPPPPPPPPP
PPPPPPPPPPPPPPPP.............................................E........PPPPPPPPPP
PPPPPPPPPPPPPPPP.............................................E........PPPPPPPPPP
PPPPPPPPPPPPPPPP...................E.........................E........PPPPPPPPPP
PPPPPPPPPPPPPPPP...................E.......................DCCCCCDCCCCPPPPPPPPPP
PPPPPPPPPPPPPPPPCCCCCCCCCCCCCCCCCCCCCCCCCDCCCCCDCCCCCDCCCCCDCCCCCDCCCCPPPPPPPPPP
PPPPPPPPPPPPPPPPCCCCCCCCCCCCCCCCCCCCCCCCCDCCCCCDCCCCCDCCCCCDCCCCCDCCCCPPPPPPPPPP
PPPPPPPPPPPPPPPPCCCCCCCCCCCCCCCCCCCCCCCCCDCCCCCDCCCCCDCCCCCDCCCCCDCCCCPPPPPPPPPP
PPPPPPPPPPPPPPPPPPPPPPPPPPPPPPPPPPPPPPPPPPPPPPPPPPPPPPPPPPPPPPPPPPPPPPPPPPPPPPPP
PPPPPPPPPPPPPPPPPPPPPPPPPPPPPPPPPPPPPPPPPPPPPPPPPPPPPPPPPPPPPPPPPPPPPPPPPPPPPPPP
PPPPPPPPPPPPPPPPPPPPPPPPPPPPPPPPPPPPPPPPPPPPPPPPPPPPPPPPPPPPPPPPPPPPPPPPPPPPPPPP
