PPPPPPPPPPPPPPPPPPPPPPPPPPPPPPPPPPPPPPPPPPPPPPPPPPPPPPPPPPPPPPPPPPPPPPPPPPPPPPPP
PPPPPPPPPPPPPPPPPPPPPPPPPPPPPPPPPPPPPPPPPPPPPPPPPPPPPPPPPPPPPPPPPPPPPPPPPPPPPPPP
PPPPPPPPPPPPPPPPPPPPPPPPPPPPPPPPPPPPPPPPPPPPPPPPPPPPPPPPPPPPPPPPPPPPPPPPPPPPPPPP
PPPPPPPPPPPPPPPPPPPPPPPPPPPPPPPPPPPPPPPPPPPPPPPPPPPPPPPPPPPPPPPPPPPPPPPPPPPPPPPP
PPPPPPPPPPPPPPPPPPPPPPPPPPPPPPPPPPPPPPPPPPPPPPPPPPPPPPPPPPPPPPPPPPPPPPPPPPPPPPPP
PPPPPPPPPPPPPPPPPPPPPPPPPPPPPPPPPPPPPPPPPPPPPPPPPPPPPPPPPPPPPPPPPPPPPPPPPPPPPPPP
PPPPPPPPPPPPPPPPPPPPPPPPPPPPPPPPPPPPPPPPPPPPPPPPPPPPPPPPPPPPPPPPPPPPPPPPPPPPPPPP
PPPPPPPPPPPPPPPP............................VVVV......................PPPPPPPPPP
PPPPPPPPPPPPPPPP............................VVVV......................PPPPPPPPPP
PPPPPPPPPPPPPPPP............................VVVV......................PPPPPPPPPP
PPPPPPPPPPPPPPPP............................VVVV......................PPPPPPPPPP
PPPPPPPPPPPPPPPPPPPPPPPPPPPPPPPPPPPPPCCCCCCCWWWW......................PPPPPPPPPP
PPPPPPPPPPPPPPPPPPPPPPPPPPPPPPPPPPPPP..........T......................PPPPPPPPPP
PPPPPPPPPPPPPPPPPPPPPPPPPPPPPPPPPPPPP..........E......................PPPPPPPPPP
PPPPPPPPPPPPPPPPPPPPPPPPPPPPPPPPPPPPP..........E......................PPPPPPPPPP
PPPPPPPPPPPPPPPPPPPPPPPPPPPPPPPPPPPPP..........E......................PPPPPPPPPP
PPPPPPPPPPPPPPPPPPPPPPPPPPPPPPPPPPPPPCCCCA.....E......................PPPPPPPPPP
PPPPPPPPPPPPPPPPPPPPPPPPPPPPPPPPPPPPPCCCCACCCCCCCACCCCCACCCCACCCC.....PPPPPPPPPP
PPPPPPPPPPPPPPPP.....................E.......................T........PPPPPPPPPP
PPPPPPPPPPPPPPPP.............................................E........PPPPPPPPPP
PPPPPPPPPPPPPPPP.............................................E........PPPPPPPPPP
PPPPPPPPPPPPPPPP.............................................E........PPPPPPPPPP
PPPPPPPPPPPPPPPP.....................E.......................E........PPPPPPPPPP
PPPPPPPPPPPPPPPP.....................E...............DCCCCCDCCCCCCCCCCPPPPPPPPPP
PPPPPPPPPPPPPPPP.........DCCCCDCCCCCCCCCDCCCCCCCDCCCCDCCCCCDCCCCCCCCCCPPPPPPPPPP
PPPPPPPPPPPPPPPPCCCCCCCCCDCCCCDCCTCCCCCCDCCCCCCCDCCCCCCCCCCCCCCCCCCCCCPPPPPPPPPP
PPPPPPPPPPPPPPPP.......T.........E.......................E............PPPPPPPPPP
PPPPPPPPPPPPPPPP.......E.........E....................................PPPPPPPPPP
PPPPPPPPPPPPPPPP.......E.........E....................................PPPPPPPPPP
PPPPPPPPPPPPPPPP.......E.........E....................................PPPPPPPPPP
PPPPPPPPPPPPPPPPCA.....E.........E.......................E............PPPPPPPPPP
PPPPPPPPPPPPPPPPCACCCCCCACCCCACCCCCACCCCCA...............E............PPPPPPPPPP
PPPPPPPPPPPPPPPPCCCCCCCCACCCCACCCCCACCCCCACCCCCACCCCCACCCCCCCCCCC.....PPPPPPPPPP
PPPPPPPPPPPPPPPP...............E....CCCCCACTCCCACCCCCACCCCCCCTCCC.....PPPPPPPPPP
PPPPPPPPPPPPPPPP...........................E.................E........PPPPPPPPPP
PPPPPPPPPPPPPPPP...........................E.................E........PPPPPPPPPP
PPPPPPPPPPPPPPPP...........................E.................E........PPPPPPPPPP
PPPPPPPPPPPPPPPP...............E...........E.................E........PPPPPPPPPP
PPPPPPPPPPPPPPPP...............E...........E.................E........PPPPPPPPPP
PPPPPPPPPPPPPPPP...............E.......T...E.........DCCCCCDCCCCCCCCCCPPPPPPPPPP
PPPPPPPPPPPPPPPPCCCCCCCCCCCCCDEEECCCDCCECCDCCCCDCCCCCDCCCCCDCCCCCCCCCCPPPPPPPPPP
PPPPPPPPPPPPPPPPCCCCCCCTCCCCCDCCCCCCDCCECCDCCCCDCCCCCD................PPPPPPPPPP
PPPPPPPPPPPPPPPP.......E...............E..............................PPPPPPPPPP
PPPPPPPPPPPPPPPP.......E...............E..............................PPPPPPPPPP
PPPPPPPPPPPPPPPP.......E...............E..............................PPPPPPPPPP
PPPPPPPPPPPPPPPPCCCA...E...............E..............................PPPPPPPPPP
PPPPPPPPPPPPPPPPCCCACCCCCACCCCCACCCCCA.E..............................PPPPPPPPPP
PPPPPPPPPPPPPPPPCCCACCCCCACCCCCACCCCCACCCCCACCCCCACCCCCACCCACCCCC.....PPPPPPPPPP
PPPPPPPPPPPPPPPP...................ECACCCCC..................T........PPPPPPPPPP
PPPPPPPPPPPPPPPP.............................................E........PPPPPPPPPP
PPPPPPPPPPPPPPPP.............................................E........PPPPPPPPPP
PPPPPPPPPPPPPPPP.............................................E........PPPPPPPPPP
PPPPPPPPPPPPPPPP...................E.........................E........PPPPPPPPPP
PPPPPPPPPPPPPPPP...................E......................CDCCCCCDCCCCPPPPPPPPPP
PPPPPPPPPPPPPPPPCCCCCCCCCCCCCCCCCCCCCCCCCDCCCCCDCCCCCDCCCCCDCCCCCDCCCCPPPPPPPPPP
PPPPPPPPPPPPPPPPCCCCCCCCCCCCCCCCCCCCCCCCCDCCCCCDCCCCCDCCCCCDCCCCCDCCCCPPPPPPPPPP
PPPPPPPPPPPPPPPPCCCCCCCCCCCCCCCCCCCCCCCCCDCCCCCDCCCCCDCCCCCDCCCCCDCCCCPPPPPPPPPP
PPPPPPPPPPPPPPPPPPPPPPPPPPPPPPPPPPPPPPPPPPPPPPPPPPPPPPPPPPPPPPPPPPPPPPPPPPPPPPPP
PPPPPPPPPPPPPPPPPPPPPPPPPPPPPPPPPPPPPPPPPPPPPPPPPPPPPPPPPPPPPPPPPPPPPPPPPPPPPPPP
PPPPPPPPPPPPPPPPPPPPPPPPPPPPPPPPPPPPPPPPPPPPPPPPPPPPPPPPPPPPPPPPPPPPPPPPPPPPPPPP